{
    "level": {
        "grid_x": 8,
        "grid_y": 8, 
        "rotation" : 0.0,
        "moves" : 3
    },
    "grid" : [
    	[  1,  2,  3, -1, 2,  3,  1,  1],
    	[  2,  3,  1,  1, 2,  3,  1,  1],
    	[ -1,  1,  0,  2, 2,  3,  1,  1],
    	[  2,  1,  3,  1, 2,  3,  1,  1],
    	[  2,  1,  3,  1, 2,  3,  1,  1],
    	[  2,  1,  3,  1, 2,  3,  1,  1],
    	[  2,  1,  3,  1, 2,  3,  1,  1],
    	[  2,  1,  3,  1, 2,  3,  1,  1]
    	]
}