{
    "level": {
        "grid_x": 8,
        "grid_y": 8, 
        "rotation" : 0.0,
        "moves" : [21],
    },	
    	"grid" : [
    	[  1,  1,  2,  3,  1,  2,  3,  1],
    	[  1, -1,  2,  2,  3, -1,  2,  2],
    	[  2,  3,  2,  4,  1,  2, -1,  3],
    	[  1,  2,  3,  2,  1,  2,  2,  1],
    	[  1,  3,  3,  1, -1,  1,  3,  1],
    	[  1,  2,  3,  2,  1, -1,  3,  2],
    	[  2,  2,  1,  3, -1,  2,  1,  1],
    	[  0,  1,  3,  2,  2,  2,  1,  2]
    	]
}