{
    "level": {
        "grid_x": 8,
        "grid_y": 8, 
        "rotation" : 0.0,
        "moves" : [8,18],
		"start" : 1
    },	
    	"grid" : [
    	[ -1,  1,  1,  3,  3,  2,  2, -1],
    	[  1,  3,  1,  3,  3,  1,  3,  2],
    	[  3,  1,  2, -1,  1,  2,  2,  1],
    	[  2,  2,  4,  1,  2,  3,  1,  3],
    	[  2,  3,  1,  2,  3,  2,  2,  3],
    	[  1,  3,  2, -1,  2,  1,  3,  2],
    	[  1,  2, -1, -1,  1,  3,  0,  3],
    	[ -1,  1,  2,  3,  2,  2,  3, -1]
    	]
}