{
    "level": {
        "grid_x": 8,
        "grid_y": 8, 
        "rotation" : 0.0,
        "moves" : [5,25],
        "start" : 2
        
    },
    "grid" : [
    	[  2,  1,  2,  2,  3, -1,  2,  1],
    	[  2, -1,  2,  2,  3, -1,  2,  1],
    	[  4,  1,  2,  3,  1,  2,  1,  3],
    	[  1,  2,  0,  2,  1,  2,  2, -1],
    	[  2,  3,  3,  1, -1,  1,  3,  1],
    	[  3,  2,  2,  2,  3,  1,  3,  2],
    	[  4,  1,  1,  3, -1,  2,  2,  1],
    	[  2,  2,  3,  1,  2,  2,  2,  2]
    	]
}